48 c7 c7 70 16 67 55 c3
00 00 00 00 00 00 00 00
00 00 00 00 00 00 00 00
00 00 00 00 00 00 00 00
00 00 00 00 00 00 00 00
00 00 00 00 00 00 00 00
00 00 00 00 00 00 00 00
28 16 67 55 00 00 00 00
0d 1a 40 00 00 00 00 00
31 64 36 66 38 66 61 35
